###############################
#                             #
#                             #
#       X                     #
#                      ########
#       O     X        #
#                      #
#####                  #
    #         P        #
    #                   #
    #                   #
    #                   #
    #####################
