000000000000000000000000000000
011111111111111110000000000000
011111111111111111111111000000
011110000000000110000001100000
011110000000000110000001100000
012110000111111110001111111110
011110000111111110001110001110
011110001111000110001110001110
000011111111011111101111011110
011110001111000111101112111100
011211101100000111101111211100
011111111110001111100111111111
011100011110000111100000000000
011000111111000111000000000000
010000011111111100000000000000
010000000000000000000000000000